AccountAccidentEncounter1 = account-accident-encounter1
AccountOpdEncounter1 = account-opd-encounter1
AllergyIntolerance1 = allergyintolerance-patient4
OpdAppointment = appointment-opd1
FPAppointment = appointment-fp
ANCAppointment = appointment-anc
LaborAppointment = appointment-labor
PostLaborAppointment = appointment-postnatal
File1Composition = composition-file-1
ClaimAccidentEncounter1 = claim-accident-encounter1
ClaimIpdEncounter1 = claim-ipd-encounter1
ClaimLabEncounter1 = claim-lab-encounter1
ClaimOpdEncounter1 = claim-opd-encounter1
AccidentCondition1 = condition-accident1
ChronicCondition1 = condition-chronic1
DisabilityCondition1 = condition-disability1
NcdCondition1 = condition-ncd1
NcdConditionSum = condition-ncd-summary
LaborCondition1 = condition-pregnancy-outcome
SurvCondition1 = condition-surveillance1
SurvCondition2 = condition-surveillance2
CoverageSSO = coverage-sso
CoverageUC = coverage-uc
RehabDevice1 = devicerequest-rehab-device1
LipidDiagnosticReport = diagnostic-report-lipid1
AccidentEncounter1 = encounter-accident1
ChronicEncounter1 = encounter-chronic1
ChronicEncounter2 = encounter-chronic2
DeathEncounter = encounter-death1
DentalEncounter1 = encounter-dental1
FunctionalEncounter = encounter-functional1
IpdEncounter1 = encounter-ipd1
LabEncounter1 = encounter-lab1
NcdEncounter1 = encounter-ncd1
OpdEncounter1 = encounter-opd1
FPEncounter1 = encounter-fp
PrenatalEncounter1 = encounter-prenatal1
ANCEncounter1 = encounter-anc1
LaborEncounter1 = encounter-labor1
PostnatalEncounter1 = encounter-postnatal1
RehabEncounter1 = encounter-rehab1
SurvEncounter1 = encounter-surveillance1
ChronicEpisode1 = episodeofcare-chronic1
OpdGPClinic1 = location-opd-gp-clinic1
Patient1Home = location-patient1-home1
Village1 = location-village1


AccidentInjuryLocation = observation-accident-injury-location
AccidentInjuryType = observation-accident-injury-type
AccidentVehicleType = observation-accident-vehicle-type
AccidentAlcoholUse = observation-accident-alcohol-use
AccidentDrugUse = observation-accident-drug-use
AccidentSeatbelt = observation-accident-seatbelt
AccidentHelmet = observation-accident-helmet
AccidentBreathing = observation-accident-breathing
AccidentBleeding = observation-accident-bleeding
AccidentSprint = observation-accident-sprint
AccidentIVFluid = observation-accident-iv-fluid
AccidentGCS = observation-accident-gcs
RiskBehavior1= observation-risk-behavior1
CauseOfDeath1 = observation-cause-of-death1
CauseOfDeath2 = observation-cause-of-death2


BloodGroup = observation-blood-group1
BloodGroupABO = observation-blood-group-abo1
BloodGroupRh = observation-blood-group-rh1
RoleInHouse = observation-role-in-house1
RoleInVillage = observation-role-in-village1
Occupation = observation-occupation1

FunctionalTest = observation-functional-test1
FunctionalConclusion = observation-functional-conclusion1

ObsChol = observation-lab-chol
ObsTG = observation-lab-tg
ObsLDL = observation-lab-ldl
ObsHDL = observation-lab-hdl
SpecimenLipid = specimen-lab-lipid


ObsNcdVitalSignsPanel = observation-ncd-vitalpanel1
ObsNcdWt01 = observation-ncd-wt1
ObsNcdHt01 = observation-ncd-ht1
ObsNcdBp01 = observation-ncd-bp1
ObsNcdBp02 = observation-ncd-bp2
ObsNcdWC01 = observation-ncd-wc1
ObsNcdSmoking = observation-ncd-smoking1
ObsNcdAlcohol = observation-ncd-alcohol1
ObsNcdDMFamily = observation-ncd-dm-fam1
ObsNcdHTFamily = observation-ncd-ht-fam1
ObsNcdFbs = observation-ncd-fbs
ObsHighGlucoseHx = observation-ncd-hi-glucose1
ObsNcdDyslipedima = observation-ncd-dyslipid1
ObsNcdGestDM = observation-ncd-gest-dm1
ObsNcdFootExam = observation-ncd-foot1
ObsNcdRetinaExam = observation-ncd-retina1

ObsAncGravida = observation-anc-gravida
ObsAncPeriod = observation-anc-period
ObsAncGA = observation-anc-ga
ObsAncResult = observation-anc-result
ObsAncWeight = observation-anc-weight
ObsAncHeight = observation-anc-height
ObsAncThal = observation-anc-thal
ObsAncUrineSugar = observation-anc-urine-sugar
ObsAncUrineProtein = observation-anc-urine-protein
ObsAncNipple = observation-anc-nipple
ObsAncHeadache = observation-anc-headache
ObsAncNausea = observation-anc-nausea
ObsAncThyroid = observation-anc-thyroid
ObsAncFetalMovement = observation-anc-fetal-movement
ObsAncDischarge = observation-anc-discharge
ObsAncEdema = observation-anc-edema
ObsAncVaginalBleed = observation-anc-vaginal-bleed
ObsAncCramp = observation-anc-cramp
ObsAncKUB = observation-anc-kub
ObsAncHeart = observation-anc-heart
ObsAncFundalHeight = observation-anc-fundal-height
ObsAncFetusPosition = observation-anc-fetus-position
ObsAncFetalPresentation = observation-anc-fetal-presentation
ObsAncFetalHeartSound = observation-anc-fetal-heart-sound
ObsAncFetalHeartRate = observation-anc-fetal-heart-rate
ObsAncBMI = observation-anc-bmi


ContraceptiveObs = observation-fp-contraception1
PregnancyTest01 = observation-fp-preg-test1


ObsLaborGravida = observation-labor-gravida1
ObsLaborLMP = observation-labor-lmp1
ObsLaborEDC = observation-labor-edc1
ObsLaborDateTime = observation-labor-date-time1
ObsLaborLiveBirth = observation-labor-live-birth1
ObsLaborStillborn = observation-labor-stillborn1


ObsPostnatalGravida = observation-postnatal-gravida1
ObsPostnatalBirthDate = observation-postnatal-birth-date1
ObsPostnatalFundalHeight = observation-postnatal-fundal-height1
ObsPostnatalLochia = observation-postnatal-lochia1
ObsPostnatalnipple = observation-postnatal-nipple1
ObsPostnatalBreastfeeding = observation-postnatal-breastfeeding1
ObsPostnatalMens = observation-postnatal-mens1
ObsPostnatalUrineProtein = observation-postnatal-urine-protein1
ObsPostnatalUrineSugar = observation-postnatal-urine-sugar1
ObsPostnatalPerineum = observation-postnatal-perineum1
ObsPostnatalStatus = observation-postnatal-status1


ObsOBGravida = observation-prenatal-gravida1
ObsOBLMP = observation-prenatal-lmp1
ObsOBEDC = observation-prenatal-edc1
ObsOBVDRL = observation-prenatal-vdrl1
ObsOBHBsAg = observation-prenatal-hbsag1
ObsOBHIV = observation-prenatal-hiv1
ObsOBHct = observation-prenatal-hct1
ObsOBThal = observation-prenatal-thal1
ObsOBHeight = observation-prenatal-height1
ObsOBContraceptive = observation-prenatal-contraception1
ObsOBGeneralSymptom = observation-prenatal-general-symptom1

ObsVitalSignsPanel = observation-vital-panel1
ObsWt01 = observation-vital-wt1
ObsHt01 = observation-vital-ht1
ObsBT01 = observation-vital-bt1
ObsBp01 = observation-vital-bp1
ObsHR01 = observation-vital-hr1
ObsRR01 = observation-vital-rr1
ObsWC01 = observation-vital-wc1
ObsHC01 = observation-vital-hc1
ObsPE01 = observation-vital-pe1
ObsGA01 = observation-vital-ga1
ObsHeent01 = observation-vital-heent1
ObsHeart01 = observation-vital-heart1
ObsChest01 = observation-vital-chest1
ObsAbd01 = observation-vital-abd1
ObsExt01 = observation-vital-ext1
ObsNeu01 = observation-vital-neu1
ObsMisc01 = observation-vital-misc1

Contraceptive = observation-woman-contraceptive1
NoContraceptiveReason = observation-woman-no-contraceptive-reason1
NumParity = observation-woman-num-parity1
NumLivingBirth = observation-woman-num-living-birth1
NumAbortion = observation-woman-num-abortion1
NumStillbirth = observation-woman-num-stillbirth1


OrganizationNHSO = organization-nhso
OrganizationSSO = organization-sso


OrganizationMain = organization-main
OrganizationSecond = organization-second
OrganizationThird = organization-third
OrganizationFourth = organization-fourth
OrganizationMedicalCouncil = organization-medical-council

Patient1 = patient-patient1
Patient2 = patient-patient2
Patient3 = patient-patient3
Patient4 = patient-patient4
Patient5 = patient-patient5
Patient6 = patient-patient6

Patient1Mother = relatedperson-patient1-mother
Patient1Father = relatedperson-patient1-father
Patient1Spouse = relatedperson-patient1-spouse


PractitionerDentist1 = practitioner-dentist1
PractitionerDoctor1 = practitioner-doctor1
PractitionerDoctor2 = practitioner-doctor2
PractitionerVolunteer1 = practitioner-volunteer1

PractitionerRoleDoctor1 = practitionerrole-doctor1

ReferOutAccidentEncounter1 = servicerequest-refer-out-accident1
ReferInOpdEncounter1 = servicerequest-refer-in-opd1
ReferOutOpdEncounter1 = servicerequest-refer-out-opd1


LaborProcedure01 = procedure-labor1

QnDentalAnswer = questionnaireresponse-dental1
QnHomeAnswer = questionnaireresponse-home1
QnVillageAnswer = questionnaireresponse-village1

TH-dental = questionnaire-dental
TH-home = questionnaire-home
TH-village = questionnaire-village